222220000000000000000000000000000000000000000000000000000000000000000
111110000000000000000000000000000000000000000000000000000000000000000
111110000000000000000000000000000000000000000000000000000000000000000
111110020020002000020000020000000000000000000000000000000000000000000
111110010010001000010000010000000000000000000000000000000000000000000
111110010010001000010000010000000000000000000000000000000000000022222
111110010010001000010000010000000000000000000000000000000000000011111
111110010010001000010000010000000022220000022220000222200022220011111
111110000000000000000000000000000000000000000000000000000000000011111
111112000000000000000000000000000000000000000000000000000000000011111
111111000000000000000000000000000000000000000000000000000000000211111
111111000000000000000000000000000000000000000000000000000000002111111
111111000000000000000000000000000000000000000000000000000000021111111
111111222222222222222222222222000022222222222222222222222222211111111
111111111111111111111111111110000111111111111111111111111111111111111
111111111111111111111111111100001111111111111111111111111111111111111
111111111111111111111111111000011111111111111111111111111111111111111
111111111111111111111111110000111111111111111111111111111111111111111
111110000000000000000001100001111111111111111111111111111111111111111
111110000000000000000001000011111111111111111111111111111111111111111
111110000000000000000000000111111111111111111111111111111111111111111
111110000000000000000000001111111111111111111111111111111111111111111
111110000000000000000000011111111111111111111111111111111111111111111
111110000000000000000000111111111111111111111111111111111111111111111
111110000000000000000001111111111111111111111111111111111111111111111
111111111111111111111111111111111111111111111111111111111111111111111
111111111111111111111111111111111111111111111111111111111111111111111
111111111111111111111111111111111111111111111111111111111111111111111
111111111111111111111111111111111111111111111111111111111111111111111
111111111111111111111111111111111111111111111111111111111111111111111